upper_latin,count_2015,count_1995,count_growth,alive_growth,dead_growth
pyrus calleryana,58931,31295,27636,28030,-359
zelkova serrata,29258,5740,23518,23613,-94
quercus palustris,53185,36553,16632,16962,-298
tilia americana,13530,95,13435,13435,0
tilia tomentosa,7995,57,7938,7939,0
ginkgo biloba,21024,13758,7266,7543,-248
prunus cerasifera,6879,48,6831,6832,0
quercus bicolor,6598,2,6596,6596,0
ulmus parvifolia,5345,55,5290,5290,0
prunus virginiana,4888,6,4882,4882,0
